11
8
00001000000
11111110111
10000010101
11111111111
00100011100
00101111111
00111010100
00001011100
7
4
4
0
4
7
10
5
7
7