10
11
1111011111
0010010100
1111010111
0101101101
1110011001
1011110111
1110111100
0011000111
1100111011
1011101010
1110101110
9
8
0
0
1
8
4
8
9
0